,terms,Popular_count,Founders_count,Legal_count,Total_count,Popular,Founders,Legal
0,a,1475123,1149734,435899,3060756,0.36651168427845937,0.338432486236826,0.2950558294847146
1,ability,2273,2232,907,5412,0.30765054072981407,0.3579047954150012,0.3344446638551848
2,abridging,99,74,55,228,0.2941989633367235,0.2605270028393272,0.44527403382394926
3,absence,3451,6750,1384,11585,0.22676627309899225,0.5254753596527209,0.24775836724828687
4,absent,2014,4282,1052,7348,0.2023520200371999,0.5096943518804123,0.28795362808238784
5,absolutely,5154,5668,991,11813,0.35376999035781814,0.46091569532707083,0.1853143143151112
6,accept,3633,10518,1573,15724,0.1782697553546757,0.6114493915567437,0.21028085308858058
7,acceptance,1584,3246,767,5597,0.21066205709468847,0.5114400560502903,0.27789788685502126
8,according,22895,13896,15037,51828,0.28503487944416894,0.20495675908905725,0.5100083614667739
9,accordingly,7930,8836,4575,21341,0.25695069252473535,0.3391933994332919,0.4038559080419727
10,account,29810,39210,15050,84070,0.25421298300798,0.39613906587004105,0.34964795112197894
11,accusation,1218,468,148,1834,0.5598331885217589,0.2548427518042706,0.1853240596739706
12,accused,2005,594,410,3009,0.5240877207953739,0.18394633216022924,0.2919659470443969
13,act,38274,36752,32994,108020,0.22291061832278009,0.2535846503872094,0.5235047312900105
14,acts,11442,8712,5164,25318,0.31932641549900226,0.2880486534562184,0.3926249310447794
15,actual,2663,3820,1504,7987,0.23595590866301916,0.4009942394132676,0.3630498519237131
16,actually,4428,4426,1125,9979,0.3476642135452939,0.4116981038574902,0.24063768259721582
17,adding,1763,1808,594,4165,0.3191979177540594,0.387812000255244,0.2929900819906966
18,adhering,431,254,144,829,0.3833765525027537,0.26766838231406404,0.3489550651831823
19,adjourn,559,914,995,2468,0.1284309104823092,0.24878204265042858,0.6227870468672622
20,adjournment,973,1202,1199,3374,0.17180202058718175,0.2514403513042427,0.5767576281085756
21,admiralty,1790,2216,1935,5941,0.18478559339325631,0.2710191095569859,0.5441952970497578
22,admit,6035,8474,2462,16971,0.26490690787074267,0.44067615217088174,0.29441693995837565
23,admitted,6051,4666,3601,14318,0.282899970861352,0.2584434705025361,0.45865655863611193
24,adoption,1200,1796,891,3887,0.20850974995550972,0.3697145426784949,0.4217757073659954
25,advice,7807,10046,3164,21017,0.275588769045081,0.4201318336072951,0.30427939734762377
26,affect,2714,3092,646,6452,0.3335356149005272,0.4501807668725159,0.2162836182269569
27,affecting,2108,778,167,3053,0.6049348294473587,0.2645042535955474,0.13056091695709396
28,affirm,1609,622,647,2878,0.3916240353383275,0.17935717661887732,0.4290187880427952
29,affirmation,952,218,2460,3630,0.12032195748204531,0.032642206960616225,0.8470358355573384
30,after,88614,60520,33002,182136,0.35414253374634275,0.2865429638627006,0.35931450239095664
31,against,69529,49720,19878,139127,0.3807986610906649,0.32260836902492207,0.29659296988441297
32,age,22404,5420,3729,31553,0.5746947071328762,0.16471228799936113,0.26059300486776266
33,agree,5111,7088,5434,17633,0.18052250831258143,0.2965953017733074,0.5228821899141113
34,agreement,3318,3514,1957,8789,0.2589637966004891,0.3249222927311689,0.41611391066834197
35,aid,5639,10314,16271,32224,0.09068007303205067,0.19649521263198486,0.7128247143359644
36,all,357345,202846,86157,646348,0.4293051604626058,0.28870873731893604,0.2819861022184581
37,alliance,2728,4756,843,8327,0.25593095008148686,0.5286099930245276,0.2154590568939855
38,alone,15562,8850,2048,26460,0.4920608182711488,0.33152151949578,0.17641766223307115
39,also,61156,54334,20877,136367,0.33528105988442625,0.3529041026338066,0.3118148374817671
40,alter,2177,1628,2158,5963,0.21803114029757298,0.19316550674242472,0.5888033529600022
41,ambassadors,913,1024,304,2241,0.3090362520428639,0.41063284806342437,0.2803308998937118
42,amendment,1479,1788,6901,10168,0.06603316698112247,0.09457504296663838,0.8393917900522392
43,amendments,1332,2308,5193,8833,0.07313158826200093,0.1501245315361826,0.7767438802018165
44,america,31310,50110,7425,88845,0.28231538085905694,0.5352922489616289,0.18239237017931412
45,among,49427,28884,5404,83715,0.5024670040681328,0.34786898716350056,0.14966400876836644
46,an,259642,231836,109548,601026,0.31178993501260144,0.32982464283055063,0.3583854221568478
47,and,2974212,1596026,989780,5560018,0.3933344521054429,0.25006050754911713,0.35660504034544005
48,another,44491,31698,9692,85881,0.41025060814246866,0.3462772878997461,0.24347210395778532
49,answer,22747,35894,5782,64423,0.2807463413314423,0.5248399871719962,0.19441367149656152
50,any,203149,201598,159242,563989,0.23195486892222114,0.2727031180526654,0.4953420130251134
51,appellate,74,84,183,341,0.11010797076957858,0.14807488543490654,0.7418171437955149
52,application,6273,12818,4585,23676,0.1847731187801936,0.44729994945566165,0.36792693176414487
53,appoint,3041,5778,7633,16452,0.09911650320398724,0.2231116095761476,0.6777718872198653
54,appointed,15759,19198,24505,59462,0.14971104075358102,0.21607088032940702,0.634218078917012
55,appointment,3954,14876,4322,23152,0.11855220041116682,0.5284138643601132,0.35303393522872006
56,appointments,659,3606,802,5067,0.09260818376266568,0.600350331446936,0.30704148479039844
57,apportioned,104,244,574,922,0.053147096088514,0.14772401645834607,0.79912888745314
58,appropriation,473,1316,1689,3478,0.07130503934299208,0.23503365398321255,0.6936613066737954
59,appropriations,316,1026,1702,3044,0.05122950678460136,0.19705866347932338,0.7517118297360752
60,approve,2413,4416,932,7761,0.23694528532630937,0.5137299607465335,0.24932475392715706
61,approved,3168,4296,3127,10591,0.1888354566469161,0.30337355633740576,0.5077909870156783
62,are,396850,327170,83298,807318,0.39238272207863073,0.38324107095701765,0.22437620696435173
63,arising,3534,3162,3631,10327,0.20579895182287708,0.21814916699919962,0.5760518811779233
64,armies,4095,3624,922,8641,0.3756796096212926,0.3938827731460498,0.23043761723265763
65,arming,314,770,468,1552,0.1255389062008432,0.3647157324811948,0.509745361317962
66,arms,17405,15020,4780,37205,0.36093681667276756,0.3690134270366434,0.270049756290589
67,army,17906,53574,11623,83103,0.1584028265024558,0.5614789770848785,0.28011819641266583
68,arrest,992,1904,922,3818,0.17223627108845693,0.391647146274982,0.43611658263656117
69,arsenals,73,324,201,598,0.0726774709091777,0.3821527913300895,0.5451697377607329
70,article,9960,15224,7564,32748,0.2049258895400469,0.3710917897482423,0.4239823207117108
71,articles,11195,19496,8497,39188,0.19489615090490053,0.4021052657761136,0.40299858331898586
72,arts,6230,2550,548,9328,0.5798606287511769,0.2811841497185862,0.13895522153023707
73,as,609424,648608,216063,1474095,0.30990802210749757,0.39076049042827316,0.29933148746422933
74,ascertained,1825,2700,1612,6137,0.19383242476707938,0.3397366531350821,0.4664309220978385
75,assemble,1251,1570,490,3311,0.2813811788349101,0.41836222835775466,0.30025659280733524
76,assembled,4545,2924,4594,12063,0.22144093903676465,0.16877824833135957,0.6097808126318758
77,assistance,8720,9918,1146,19784,0.36961508323227943,0.49804935806005357,0.13233555870766697
78,at,386469,392900,114940,894309,0.3317106706603653,0.39952309359419613,0.2687662357454385
79,attainder,184,52,276,512,0.18445768753573225,0.06175858834168915,0.7537837241225785
80,attained,1604,428,219,2251,0.592387668778144,0.18726667296257,0.220345658259286
81,attainted,160,88,307,555,0.14537225985389138,0.09472384343187429,0.7599038967142344
82,attendance,3513,2106,1945,7564,0.31069725647694874,0.22066462448898644,0.46863811903406494
83,authority,23906,14806,23553,62265,0.22635484132619021,0.16608702182910412,0.6075581368447056
84,authorized,2656,5962,9911,18529,0.07233102823988512,0.19235506217008078,0.7353139095900342
85,authors,3369,972,275,4616,0.639311059484126,0.2185206840792904,0.14216825643658354
86,bail,955,524,2177,3656,0.12722060826058074,0.08269903904916663,0.7900803526902526
87,ballot,799,368,976,2143,0.20519187193611935,0.11196345019140634,0.6828446778724742
88,bankruptcies,81,122,41,244,0.2401900839322803,0.4285928935537696,0.3312170225139501
89,be,751032,925672,497499,2174203,0.23447468157374354,0.342381050603309,0.4231442678229474
90,bear,12795,5790,1689,20274,0.5275004882023907,0.2827979256114548,0.1897015861861545
91,become,19485,14884,5315,39684,0.3776299798103788,0.3417439199406239,0.28062610024899715
92,been,181443,232108,57662,471213,0.29574311619972715,0.44820801266216137,0.2560488711381115
93,before,97389,85530,42498,225417,0.30966663126749583,0.32219445007150604,0.3681389186609983
94,behavior,5529,2654,981,9164,0.4873167220317257,0.2771282012423043,0.23555507672596987
95,being,115376,93340,38684,247400,0.3482046786883233,0.33373518872149344,0.3180601325901832
96,belonging,9870,7770,5556,23196,0.28849860160022195,0.2690683766853031,0.44243302171447485
97,best,31537,41328,13010,85875,0.27200554422925394,0.42229588259072653,0.3056985731800196
98,between,42403,43574,14206,100183,0.3194737296554949,0.3889386273568401,0.29158764298766504
99,bill,8986,15712,28331,53029,0.08575809347211143,0.1776459266379573,0.7365959798899312
100,bills,5004,11886,10967,27857,0.10219915853332831,0.2875946646930835,0.6102061767735881
101,blessings,6522,2022,341,8885,0.6623676916626982,0.24328457688707383,0.094347731450228
102,blood,21281,2818,682,24781,0.803738267087173,0.12608943053642024,0.07017230237640694
103,borrow,965,1674,801,3440,0.18809443014987662,0.3865619966465129,0.4253435732036104
104,both,46068,36144,7482,89694,0.42159074742150043,0.39187089284474497,0.18653835973375457
105,bound,12894,8742,4127,25763,0.3738031469470684,0.3002487234505985,0.32594812960233305
106,branch,5303,4414,2535,12252,0.30409712693202534,0.29987350703895915,0.3960293660290155
107,breach,2282,2398,1802,6482,0.22746787185315445,0.283183981282493,0.48934814686435263
108,bribery,382,190,166,738,0.36060384760523495,0.2124886192090251,0.42690753318574
109,buildings,3241,2750,1751,7742,0.2875963626065231,0.2891026894667505,0.4233009479267263
110,business,22272,43558,8494,74324,0.22956951707293924,0.5319098262461337,0.238520656680927
111,but,415936,317428,58723,792087,0.4369171012838751,0.39503251667277617,0.16805038204334863
112,by,607861,494936,272671,1375468,0.31380519152595493,0.3027052603839422,0.383489548090103
113,call,18550,14088,3795,36433,0.406984602775643,0.36618326123432315,0.22683213599003374
114,called,38671,17528,10669,66868,0.43694784705730505,0.2346343788781476,0.32841777406454736
115,calling,4277,2958,1349,8584,0.3733248767569028,0.3058869364215129,0.3207881868215844
116,cannot,44657,51112,9743,105512,0.3389437968571429,0.45959585259760893,0.2014603505452482
117,capital,4848,4732,1649,11229,0.32435694112202523,0.3750769717356555,0.3005660871423191
118,capitation,42,14,80,136,0.15188117536992737,0.059978800300605414,0.7881400243294672
119,captures,435,982,585,2002,0.13627295314533955,0.3644575727068745,0.499269474147786
120,care,21502,17620,4457,43579,0.3943942735430032,0.38288885668556016,0.2227168697714366
121,carrying,5171,5514,2984,13669,0.2607281371136702,0.3293784683662415,0.40989339452008833
122,case,31604,44408,27420,103432,0.19887244912232394,0.33106164097746726,0.4700659099002088
123,cases,13220,11412,11100,35732,0.23201123295803708,0.23727632098943707,0.5307124460525259
124,cause,32544,22596,12913,68053,0.34440614354993937,0.2833000197066328,0.37229383674342786
125,census,232,336,607,1175,0.10158819446600766,0.1743049073034298,0.7241068982305626
126,certain,27533,24080,14345,65958,0.2893901914696299,0.2998484685354967,0.4107613399948735
127,certificates,4079,5294,5275,14648,0.16499669772331427,0.25370005651374505,0.5813032457629407
128,certify,670,918,1472,3060,0.11616262275569637,0.18855991236498185,0.6952774648793217
129,cession,290,1198,812,2300,0.07395236043174376,0.3619311316358871,0.5641165079323692
130,charged,4046,6190,3742,13978,0.18754207112367097,0.33992144048322775,0.47253648839310125
131,chief,13345,11362,6233,30940,0.30477444501014034,0.30741838449390196,0.3878071704959576
132,choice,7756,5332,2059,15147,0.3940596253970521,0.3209440735567219,0.28499630104622586
133,choose,6613,5580,2130,14323,0.34756717684094285,0.3474477571842055,0.3049850659748517
134,choosing,1507,764,473,2744,0.4072169610231065,0.2445800586861397,0.34820298029075375
135,chosen,7775,4142,5364,17281,0.28484677831621413,0.1797778112836262,0.5353754104001598
136,citizen,5000,5092,2757,12849,0.26963558769988233,0.3253199392090833,0.40504447309103425
137,citizens,12666,12512,7391,32569,0.2659545843267161,0.31125032448213535,0.4227950911911486
138,civil,13983,6634,4010,24627,0.4267408434958142,0.2398581064884998,0.33340105001568593
139,claim,7523,9056,4527,21106,0.24597167268567346,0.35078864478569277,0.40323968252863385
140,claiming,535,600,989,2124,0.1357803483849097,0.18040537263695178,0.6838142789781385
141,claims,3647,5298,4859,13804,0.15746211289008455,0.2709987860269557,0.5715391010829597
142,class,3686,3260,1392,8338,0.3250314703110639,0.3405671552308765,0.33440137445805956
143,classes,1565,1150,539,3254,0.3560186958001566,0.30993554302703213,0.3340457611728112
144,clauses,402,430,632,1464,0.15266586845520805,0.19346367582888324,0.6538704557159087
145,clear,10705,7450,1939,20094,0.4314163818130039,0.35569790999322815,0.21288570819376793
146,coin,774,1258,1371,3403,0.129012393766211,0.24841979207255852,0.6225678141612306
147,collect,1930,4244,935,7109,0.20304702899556434,0.5289684694226662,0.26798450158176945
148,comfort,6862,2214,302,9378,0.665715144434732,0.2544663847650379,0.07981847080023
149,commander,5135,8002,4921,18058,0.18325205885744197,0.3383156139884195,0.4784323271541386
150,commerce,10657,16046,6095,32798,0.23031334624276295,0.4108336494847266,0.35885300427251043
151,commission,5939,13180,3036,22155,0.1991306925416453,0.523546630914338,0.2773226765440167
152,commissions,1435,5152,1288,7875,0.1298924935459154,0.5524883024786428,0.3176192039754418
153,committed,9493,6120,8865,24478,0.23213329873929592,0.17729662330674467,0.5905700779539594
154,common,29072,16446,9477,54995,0.3908877451251456,0.2619705735569232,0.34714168131793127
155,compact,1465,1310,660,3435,0.3042553376245637,0.32231977924782723,0.37342488312760913
156,compel,1361,1370,913,3644,0.24874932143927403,0.2966466352992055,0.4546040432615205
157,compelled,3038,1804,903,5745,0.39788895196116253,0.2799147114034413,0.3221963366353961
158,compensation,1988,5170,3674,10832,0.10969995168502915,0.3379836404007882,0.5523164079141827
159,composed,4430,2466,621,7517,0.4898643232758188,0.323057804388496,0.18707787233568515
160,compulsory,99,86,72,257,0.24934698222522111,0.25661524487464293,0.494037772900136
161,concerned,5664,4766,1813,12243,0.3485631470934881,0.3474780226694473,0.3039588302370646
162,concerning,10683,9052,3027,22762,0.3602598239265196,0.3616448037630444,0.27809537231043596
163,concur,1211,2000,954,4165,0.1959724033808951,0.38343861860989603,0.420588978009209
164,concurrence,1649,2118,2821,6588,0.1392318917391812,0.2118649447442646,0.6489031635165542
165,confederation,1138,2870,2678,6686,0.09616456557162058,0.2873226006653275,0.616512833763052
166,confession,2330,404,297,3031,0.6440466488593668,0.13229939219802153,0.2236539589426118
167,confronted,105,50,43,198,0.37315841062650007,0.21051789557522496,0.4163236937982749
168,congress,20066,83984,56639,160689,0.07326931334715991,0.3633063168819252,0.5634243697709149
169,connecticut,4496,7242,5499,17237,0.16024643390003504,0.3057987258710614,0.5339548402289037
170,consent,8340,6678,5042,20060,0.27811505159590083,0.2638274243843485,0.4580575240197506
171,consequence,16069,20172,4194,40435,0.3126693388428266,0.46500806375879655,0.22232259739837687
172,consideration,12301,20874,13200,46375,0.16852558559248512,0.3388021718061744,0.49267224260134057
173,consist,2929,2586,1569,7084,0.285278900538338,0.2983966073007134,0.4163244921609485
174,constitute,1824,1328,544,3696,0.37382120039641237,0.32244247708155943,0.3037363225220282
175,constitution,22669,19258,12754,54681,0.2825490029806867,0.2843725544254494,0.43307844259386397
176,construed,835,876,1054,2765,0.1760025086554225,0.21875176652276837,0.605245724821809
177,consuls,677,1958,1475,4110,0.09650671270272883,0.3306713903283127,0.5728218969689584
178,continuance,3513,4226,1955,9694,0.25372548670854106,0.36160174471302775,0.38467276857843113
179,contracted,2273,2308,791,5372,0.31735748944728615,0.38176859591622203,0.3008739146364919
180,contracts,1093,2118,946,4157,0.17687676459227383,0.40606135497719603,0.4170618804305302
181,contrary,15046,10522,7965,33533,0.30574561258784283,0.25331012762967103,0.4409442597824861
182,control,2541,1808,1007,5356,0.34215933176905905,0.28842787496235117,0.3694127932685897
183,controversies,611,302,421,1334,0.28878985846191874,0.16910745384934914,0.542102687688732
184,controversy,2417,1124,828,4369,0.40254058642932355,0.22177593344394772,0.3756834801267286
185,convene,260,448,241,949,0.1796428907592065,0.3667159343270418,0.4536411749137517
186,convened,919,690,625,2234,0.26721656719881604,0.23769061806896283,0.49509281473222105
187,convention,7008,11594,5128,23730,0.2018784589731926,0.39568015018618335,0.4024413908406242
188,conventions,487,620,723,1830,0.1526066206480344,0.23017130694527346,0.6172220724066922
189,convicted,1583,598,721,2902,0.37197179310706596,0.16647359470420436,0.4615546121887298
190,conviction,4283,2336,1000,7619,0.4381663799119135,0.28312544086745906,0.27870817922062735
191,corpus,395,258,496,1149,0.19250244842835462,0.14896146953320571,0.6585360820384397
192,corruption,3755,1130,507,5392,0.5799260191346933,0.20675507407627938,0.21331890678902718
193,counsel,3592,1268,906,5766,0.4749777075776889,0.19864207021398092,0.32638022220833024
194,counted,818,820,218,1856,0.3432112764043115,0.407602817352601,0.24918590624308745
195,counterfeiting,253,122,390,765,0.1732850672507568,0.09899551716615228,0.727719415583091
196,court,27244,35272,63895,126411,0.11206815933394124,0.17189234373681747,0.7160394969292413
197,courts,6724,7334,12733,26791,0.1342074525216674,0.17342228882777694,0.6923702586505556
198,created,3444,1522,783,5749,0.4666485331619974,0.24431857954368294,0.2890328872943197
199,credit,9098,13914,7671,30683,0.1957381734331986,0.35464731639287084,0.44961451017393056
200,crime,5359,1582,1246,8187,0.5042468219385885,0.17635223655642512,0.31940094150498644
201,crimes,4671,1350,1566,7587,0.44330932468382117,0.15179093905417065,0.40489973626200815
202,criminal,3689,1344,1704,6737,0.3717434948932359,0.16045345428555896,0.4678030508212052
203,cruel,6222,1678,294,8194,0.6904964171088583,0.2206167381618395,0.08888684472930215
204,current,2697,3202,3061,8960,0.18186571270383325,0.255803386741373,0.5623309005547937
205,danger,14646,9920,2897,27463,0.42711200188159854,0.34272792984868516,0.23016006826971633
206,day,92445,65690,38589,196724,0.3356777260612905,0.28258782037825264,0.381734453560457
207,days,34965,37650,9518,82133,0.33142256450678287,0.4227937917321831,0.24578364376103393
208,death,38488,7916,4175,50579,0.6496930597015551,0.15830832331063485,0.19199861698780993
209,debate,2059,1614,2672,6345,0.18301362195422805,0.16995959201603947,0.6470267860297325
210,debts,5526,7962,8724,22212,0.1426958316584091,0.2435777753801485,0.6137263929614425
211,december,7554,10682,6144,24380,0.20445278184737128,0.34251823488646443,0.4530289832661643
212,declare,6764,4376,2382,13522,0.36685770287487607,0.28118130150220627,0.35196099562291766
213,declaring,2360,1966,1381,5707,0.27924211066127713,0.27559256860281056,0.44516532073591236
214,deem,1014,1832,1032,3878,0.16911539069816556,0.3619809601609897,0.4689036491408448
215,defend,4594,2780,1333,8707,0.39881794055930825,0.28591936567270687,0.315262693767985
216,defense,9397,8682,4507,22586,0.2940122657564852,0.3218185573375042,0.38416917690601077
217,define,360,266,239,865,0.2714423504821848,0.2376138894517187,0.4909437600660964
218,delaware,6261,5392,6948,18601,0.1982734399876664,0.2022953040000189,0.5994312560123148
219,delay,3875,12710,2386,18971,0.15236107100661797,0.5920562098342105,0.2555827191591716
220,delegated,741,642,545,1928,0.2481293497412297,0.2546889116555839,0.49718173860318654
221,delivered,10569,11474,6716,28759,0.24892239369391714,0.3201547844061011,0.43092282189998177
222,demand,5489,8166,4293,17948,0.20436404793716093,0.3601933755218693,0.43544257654096985
223,deny,5247,1508,520,7275,0.6209317885326304,0.21142154952410783,0.16764666194326172
224,department,2869,19848,7445,30162,0.06147960887679551,0.5038861008911256,0.4346342902320789
225,departments,1377,3674,1745,6796,0.1313480098065765,0.4151870398874666,0.453464950305957
226,deprived,3719,2428,699,6846,0.4375397937140857,0.33841931481106285,0.22404089147485157
227,describing,780,282,242,1304,0.43983881173307576,0.18839229420725298,0.37176889405967134
228,desire,15355,20240,2542,38137,0.3319359183485758,0.5183582522044146,0.14970582944700958
229,determine,5332,7040,3623,15995,0.22648265296677794,0.35426850293284096,0.4192488441003811
230,determined,11768,11470,3333,26571,0.3417265626341089,0.3945977243704958,0.26367571299539533
231,devolve,123,210,88,421,0.20113441949482005,0.4068325190248302,0.3920330614803497
232,different,26216,21868,5570,53654,0.38955151521820464,0.38496621302500206,0.22548227175679328
233,diminished,1341,1114,308,2763,0.3831573197349094,0.37709312940022915,0.23974955086486138
234,direct,7833,12788,3930,24551,0.2325038143327595,0.4496966612833886,0.3177995243838519
235,directed,12482,15600,7957,36039,0.23711533170523533,0.35108731322964165,0.41179735506512294
236,disability,94,152,551,797,0.05295238764566329,0.10144166336265177,0.8456059489916848
237,disagreement,243,266,348,857,0.16133318142381248,0.20922527198724294,0.6294415465889446
238,disapproved,351,464,180,995,0.2523205641907735,0.39516510858283094,0.35251432722639553
239,discharge,6406,7860,5662,19928,0.2056962560796731,0.2990040555055602,0.4952996884147666
240,discharged,3563,3738,3484,10785,0.20379772773922722,0.25330157620370447,0.5429006960570684
241,discipline,3737,2478,568,6783,0.45461469702411794,0.35713857051274883,0.18824673246313323
242,disciplining,68,184,126,378,0.10806464731689783,0.34642372784322273,0.5455116248398795
243,discoveries,1761,706,81,2548,0.6248932515054326,0.29680161496828733,0.07830513352628013
244,disorderly,736,322,332,1390,0.3640041795198482,0.18866854825632692,0.44732727222382496
245,disparage,47,38,19,104,0.32688501101819406,0.31310919790715125,0.3600057910746547
246,dispose,2542,2584,1105,6231,0.2951116238236961,0.3554007655456476,0.3494876106306562
247,disqualification,98,66,143,307,0.17321535005911978,0.1382035872241608,0.6885810627167195
248,district,4803,10044,7049,21896,0.1337656867451266,0.33140108122291473,0.5348332320319588
249,divided,5693,3704,2634,12031,0.32989386271854415,0.254284044442004,0.4158220928394519
250,do,108467,119830,25112,253409,0.3401872280511325,0.445247013739999,0.21456575820886856
251,dock,718,394,140,1252,0.4584390125186894,0.2980357941424427,0.2435251933388679
252,dollars,12327,19612,22998,54937,0.12550947183387987,0.23656803943207164,0.6379224887340484
253,domestic,4421,4620,1575,10616,0.31166267439507456,0.3858525136081693,0.3024848119967561
254,domestic_violence,33,12,36,81,0.22712838080704664,0.0978484140897069,0.6750232051032465
255,drawn,8461,11360,4540,24361,0.24676394089795303,0.39251242945668646,0.36072362964536053
256,due,14475,21876,17101,53452,0.16641649740603973,0.29796194426893063,0.5356215583250297
257,during,20725,19160,9782,49667,0.29576071956616995,0.3239340044507511,0.3803052759830789
258,duties,11307,13652,11838,36797,0.18929767600626435,0.27077542720880754,0.539926896784928
259,duty,25251,28578,15761,69590,0.24744735840662183,0.3317807251247327,0.4207719164686454
260,each,45473,31682,28624,105779,0.28246153729494505,0.23314890557889636,0.48438955712615855
261,effect,17664,19168,5248,42080,0.32310265642768743,0.41537786844046753,0.2615194751318452
262,effects,12955,6150,1517,20622,0.5315129846105046,0.29892804175587556,0.16955897363361996
263,eight,11064,7512,7719,26295,0.26990198058112724,0.21710236962718812,0.5129956497916845
264,either,31042,29292,12652,72986,0.30976048026075487,0.34629037440277255,0.3439491453364725
265,elected,3121,2480,2039,7640,0.26872745214712473,0.25297932342998897,0.4782932244228863
266,election,6927,5946,2742,15615,0.32306612652110156,0.3285384636699667,0.3483954098089319
267,elections,2123,1940,1092,5155,0.28703482405394193,0.31074303695383854,0.4022221389922195
268,elector,654,436,65,1155,0.4853006546880508,0.3832963628625043,0.13140298244944495
269,electors,1923,1310,841,4074,0.333498822821203,0.2691543460456436,0.39734683113315333
270,eligible,1054,2308,574,3936,0.19693235309987459,0.5108899316240815,0.29217771527604386
271,emit,183,128,168,479,0.2309642694285523,0.19138978694082126,0.5776459436306263
272,emolument,644,704,231,1579,0.3055955590654123,0.39577550398744205,0.29862893694714576
273,emoluments,464,1396,691,2551,0.11598914101749226,0.41342796524265907,0.47058289373984863
274,employed,10815,12344,5042,28201,0.27606749008790754,0.37330150098845843,0.35063100892363397
275,encreased,953,686,44,1683,0.5054129105102517,0.43101524030898064,0.0635718491807677
276,end,30014,16994,6608,53616,0.440414514851641,0.2954258130747136,0.2641596720736453
277,enemies,13409,8342,1860,23611,0.47282779222522076,0.34849124398995157,0.17868096378482767
278,engage,3849,5350,767,9966,0.3135182042842863,0.5162781129538707,0.170203682761843
279,engagements,1786,3244,816,5846,0.2274500267748649,0.48944113115663074,0.28310884206850434
280,enjoy,9145,4852,1796,15793,0.46219225285435805,0.2905191896638683,0.24728855748177364
281,enter,10833,7824,4634,23291,0.33101359534414404,0.283231146355652,0.3857552583002041
282,entered,10648,5472,6157,22277,0.31405915780640176,0.19120735243569129,0.49473348975790693
283,entitled,4421,5144,13272,22837,0.09472404181618564,0.13057371060267395,0.7747022475811404
284,enumeration,497,482,722,1701,0.16375639165477893,0.1881498990887997,0.6480937092564214
285,equal,14991,14248,5643,34882,0.3173086212169662,0.35728950078446603,0.3254018779985678
286,equally,10503,8228,2603,21334,0.3841304093873677,0.35651243850236597,0.25935715211026616
287,equity,2082,1514,1942,5538,0.22713634805039248,0.19568019337923848,0.5771834585703691
288,erected,4905,2072,901,7878,0.4997782820029501,0.25011699326396436,0.2501047247330856
289,erection,273,320,227,820,0.21487072906889235,0.2983868424687581,0.4867424284623495
290,escaping,588,234,119,941,0.4943591714270143,0.23307527594611357,0.27256555262687204
291,establish,4703,5430,2479,12612,0.26288989140668084,0.35959514364838707,0.37751496494493203
292,established,10665,9124,3589,23378,0.34125851163421395,0.345878039939644,0.3128634484261421
293,establishment,5151,7928,3317,16396,0.21844757198183265,0.398322091457523,0.38323033656064437
294,ever,49802,37916,5021,92739,0.4594254694900317,0.41438676728353024,0.12618776322643804
295,every,124711,95228,43708,263647,0.3497183591172121,0.31636862989607023,0.33391301098671766
296,ex,991,858,2380,4229,0.11670660197121223,0.11970826538353574,0.7635851326452521
297,exceed,2363,2974,2505,7842,0.18590514250854434,0.2771939364886719,0.5369009210027837
298,exceeding,3813,2874,6153,12840,0.1590032289014185,0.14198451499773257,0.6990122561008488
299,except,12837,15374,7489,35700,0.24948827420535613,0.35398801185008416,0.39652371394455965
300,excepted,1990,1886,1661,5537,0.22744207266408883,0.25537271661162103,0.5171852107242901
301,excepting,1629,1906,1242,4777,0.22405047010342924,0.31057232376863736,0.4653772061279335
302,exceptions,905,1040,685,2630,0.22606525715309633,0.30777522896960074,0.4661595138773028
303,excessive,2040,856,223,3119,0.5571269432707595,0.27695731437664833,0.1659157423525922
304,excises,166,236,279,681,0.13768165507211166,0.2318969694071942,0.6304213755206942
305,excluding,368,502,151,1021,0.2678113721964875,0.43281269749829254,0.2993759303052199
306,exclusive,2065,2946,1501,6512,0.21411410931188432,0.3618870590648398,0.42399883162327595
307,execute,2840,4082,3938,10860,0.1543108640485908,0.26276422933568283,0.5829249066157264
308,executed,3973,5074,2557,11604,0.23439034934762618,0.3546391719270786,0.41097047872529524
309,executing,1011,1560,961,3532,0.18458215987332266,0.33742576904139127,0.4779920710852861
310,execution,11912,11872,10679,34463,0.21630640188122197,0.2554016251637184,0.5282919729550597
311,executive,5049,11046,6781,22876,0.13791676231561018,0.35746358083118573,0.5046196568532041
312,exercise,10839,5240,3022,19101,0.42876078768160897,0.24556824748443468,0.3256709648339564
313,existing,1637,2702,1297,5636,0.19554308003807505,0.38237914422976016,0.42207777573216476
314,expedient,2806,6032,2223,11061,0.17528305866352062,0.446404628853596,0.3783123124828834
315,expel,453,196,100,749,0.47303928486652097,0.24247678151613125,0.28448393361734775
316,expenditures,447,1316,971,2734,0.09609993963564087,0.335186532769323,0.5687135275950362
317,expiration,1011,1500,1734,4245,0.13458367940740035,0.23656341496480915,0.6288529056277905
318,expire,889,884,418,2191,0.2891002082304912,0.3405759593183097,0.37032383245119893
319,exported,1110,1122,1363,3595,0.18041425079294907,0.21605075950887648,0.6035349896981744
320,exports,1042,1540,643,3225,0.22562872197894726,0.3950594596542301,0.37931181836682265
321,extend,4307,4176,3384,11867,0.23314483257301744,0.2678098168500349,0.49904535057694765
322,extraordinary,7630,4784,1372,13786,0.44788916704185455,0.332699594482579,0.21941123847556637
323,fact,8862,8994,2143,19999,0.3495088372673112,0.4202370884733287,0.23025407425936018
324,facto,258,220,167,645,0.2649958633352051,0.2677054109957248,0.46729872566907
325,faith,22271,3806,2156,28233,0.6820364513057694,0.13808666222928756,0.17987688646494307
326,faithfully,2076,1346,1012,4434,0.3229798011877017,0.24808936851199556,0.4289308303003026
327,favor,17793,46752,8718,73263,0.18356242317839414,0.5714126856170991,0.24502489120450688
328,felonies,132,156,294,582,0.1180925616503917,0.16534394316872897,0.7165634951808794
329,felony,569,280,1232,2081,0.13365943637531763,0.07792206809597158,0.7884184955287107
330,fifth,4423,1932,2021,8376,0.36201474990258525,0.18734043682076998,0.4506448132766449
331,fifths,204,190,238,632,0.18932968496875544,0.20890903639088143,0.6017612786403632
332,fill,4957,4382,1514,10853,0.3472975938757913,0.36372261839660674,0.288979787727602
333,fines,883,308,2817,4008,0.09896536265631638,0.04089670449540293,0.8601379328482808
334,first,84629,68252,22546,175427,0.3729612109048746,0.35634848703432515,0.2706903020608002
335,five,23799,16916,16860,57575,0.265105539125806,0.2232404295693643,0.5116540313048298
336,fix,3641,4360,7966,15967,0.11934443252465735,0.16931017327359765,0.7113453942017449
337,fled,3040,620,484,4144,0.5968862086275848,0.14421974733444012,0.2588940440379751
338,flee,879,82,76,1037,0.7429034266773642,0.08210553190606494,0.17499104141657093
339,following,27315,14546,13733,55594,0.3332680521310562,0.21025732829697927,0.4564746195719645
340,follows,5859,3430,4394,13683,0.26761657552864576,0.1856088633592156,0.5467745611121386
341,for,643185,679264,334345,1656794,0.2726763381233027,0.3411655916926683,0.3861580701840289
342,forces,3634,3408,1359,8401,0.31950409979408784,0.35498187457133706,0.3255140256345751
343,foregoing,2739,2166,1628,6533,0.28120286620164814,0.26345184422759743,0.4553452895707544
344,foreign,10866,16204,9298,36368,0.1961586482217026,0.3465573179519333,0.4572840338263642
345,forfeiture,589,594,1756,2939,0.09692863957996861,0.11580794298197339,0.787263417438058
346,form,21860,17420,7677,46957,0.3447273861078636,0.325453434858148,0.3298191790339885
347,formed,11922,7510,2351,21783,0.4379204987141371,0.3268143926218044,0.2352651086640585
348,forth,14097,3272,5691,23060,0.42108847249321507,0.11579105952543008,0.4631204679813548
349,forts,985,1444,542,2971,0.2360798737454951,0.4100199676555908,0.3539001585989141
350,found,42982,36970,9885,89837,0.37799341578235174,0.3851785959998164,0.23682798821783177
351,four,28512,20682,14012,63206,0.3126741975488495,0.2687026660196408,0.41862313643150967
352,fourteen,2087,1302,1655,5044,0.25644304910210586,0.18953723781736645,0.5540197130805278
353,fourth,6871,3262,2955,13088,0.3657524929211897,0.2057152004083499,0.4285323066704605
354,fourths,413,320,439,1172,0.20773728075151468,0.19069067199651196,0.6015720472519734
355,free,24111,12752,5580,42443,0.4430519529522836,0.2776085363213747,0.2793395107263416
356,freedom,11398,5568,1177,18143,0.537615124615441,0.3111409204625296,0.1512439549220294
357,from,463026,440826,143115,1046967,0.3367040091066289,0.37977396655799955,0.28352202433537155
358,full,24049,17992,10488,52529,0.3252626975246034,0.28829144807217943,0.3864458544032171
359,further,22523,26176,28664,77363,0.17111594372645664,0.23560396884387677,0.5932800874296665
360,general,71417,120396,55937,247750,0.19489260392489607,0.38924307394495106,0.4158643221301529
361,georgia,3654,5444,5584,14682,0.14433428267484213,0.2547617079316719,0.6009040093934861
362,give,54010,70548,17786,142344,0.29030715750788394,0.4492451037470211,0.2604477387450949
363,given,40549,40462,16241,97252,0.3054980132002273,0.3611525350505509,0.33334945174922176
364,giving,10754,12058,5174,27986,0.27479249448536525,0.36502717212960895,0.3601803333850258
365,going,12880,15862,2053,30795,0.3456322799304197,0.5042796685661763,0.15008805150340404
366,gold,7848,2856,1853,12557,0.4820719517190514,0.20783857331193195,0.31008947496901673
367,good,112795,78062,15317,206174,0.4566507764108989,0.3744114364687157,0.1689377871203853
368,governing,1053,516,308,1877,0.4206268750725088,0.24419312241786836,0.33518000250962293
369,government,52375,52860,27184,132419,0.2770325195665369,0.33124471265581906,0.391722767777644
370,grand_jury,615,384,552,1551,0.23895014950537802,0.17675776244657046,0.5842920880480515
371,grant,8170,7498,7606,23274,0.21628504685212782,0.23516081387801197,0.5485541392698602
372,granted,8245,7672,10954,26871,0.17476957999237946,0.19266323879693686,0.6325671812106836
373,granting,1667,1910,3250,6827,0.13039875413445368,0.17700530777344903,0.6925959380920973
374,grants,1767,1568,1986,5321,0.1955696242757002,0.20560136342621993,0.5988290122980799
375,greatest,17700,21600,1360,40660,0.3766358543028475,0.5445242502207206,0.0788398954764318
376,grievances,2023,1026,347,3396,0.48352463141870233,0.29052610429648457,0.22594926428481313
377,guarantee,446,850,362,1658,0.1828456536395868,0.41284191929105324,0.40431242706936
378,habeas,322,234,490,1046,0.1664820222517997,0.14333175164620574,0.6901862261019946
379,had,283269,213904,59375,556548,0.4055728609840531,0.36283052982696995,0.23159660918897707
380,happen,4154,6148,3079,13381,0.20952452861670023,0.36738153040080096,0.4230939409824988
381,have,422309,687000,96979,1206288,0.2814619039268859,0.5424517333375811,0.176086362735533
382,having,57106,58728,16411,132245,0.3331913329010255,0.40594971981088745,0.2608589472880871
383,he,555013,328814,136741,1020568,0.4213928246598718,0.29576675809225594,0.28284041724787223
384,heads,5748,3166,858,9772,0.4856252279637612,0.31689141310305446,0.1974833589331844
385,held,12687,8714,8411,29812,0.2762552263319282,0.2247937326657368,0.4989510410023349
386,herein,2638,1408,6963,11009,0.11333781358138642,0.0716667605310027,0.8149954258876109
387,high,35812,14656,3860,54328,0.5622761774743751,0.2726161902137316,0.1651076323118932
388,highest,8227,10446,1009,19682,0.3523127774518924,0.5299708691549065,0.11771635339320102
389,him,244551,173358,38142,456051,0.4415532910590853,0.3708281128838587,0.18761859605705603
390,himself,52480,23824,6639,82943,0.5312197163594979,0.28569992062535376,0.1830803630151483
391,his,604613,309366,114742,1028721,0.4709855028169443,0.28550763120681993,0.24350686597623578
392,hold,13449,9212,4827,27488,0.3585163269911543,0.290929629709904,0.35055404329894163
393,holding,3092,2200,3342,8634,0.20887558342860318,0.17607023813467113,0.6150541784367257
394,honor,28058,90892,3379,122329,0.193577004961611,0.7429127213875136,0.06351027365087536
395,house,76427,46196,39633,162256,0.31960523762971643,0.2288687660343374,0.45152599633594614
396,houses,13395,8900,5104,27399,0.3539536173005566,0.2786177134947723,0.367428669204671
397,hundred,23874,22136,32368,78378,0.17264989781737078,0.18965109839073271,0.6376990037918965
398,i,646112,1386402,116033,2148547,0.24805437480745918,0.6305845705964574,0.12136105459608332
399,if,201517,231286,77383,510186,0.29361013955868326,0.3992305670592647,0.307159293382052
400,immediately,22593,29674,5354,57621,0.3123411909811314,0.4860114847904293,0.20164732422843934
401,imminent,580,336,156,1072,0.41338222066732055,0.28371229563849915,0.3029054836941802
402,immunities,564,238,539,1341,0.2436944582787034,0.12183121809165898,0.6344743236296375
403,impairing,110,52,81,243,0.2804151078001989,0.15704609672209716,0.5625387954777039
404,impartial,2276,1360,451,4087,0.44488864723551796,0.3149437934452661,0.240167559319216
405,impeachment,800,550,1396,2746,0.1522431745044079,0.12400112167050613,0.7237557038250859
406,impeachments,211,164,199,574,0.22270674825343045,0.2050736445092554,0.572219607237314
407,importation,2113,1710,1244,5067,0.2806881584393158,0.2691136859112345,0.4501981556494497
408,imports,823,1426,836,3085,0.17181832878718595,0.35269902643540374,0.4754826447774103
409,imposed,2798,1650,1730,6178,0.29558839822385424,0.20650886427208737,0.4979027375040584
410,imposts,370,448,501,1319,0.16330926065331838,0.23426218119235948,0.6024285581543222
411,in,1601161,1298068,543435,3442664,0.3466092467586059,0.33290296645219364,0.3204877867892006
412,inability,1142,854,447,2443,0.3387194106698427,0.3000868272882468,0.3611937620419106
413,included,1778,3002,1387,6167,0.19510243683936254,0.39026239472166696,0.4146351684389706
414,including,1942,2928,1975,6845,0.1799582030445032,0.3214464062900875,0.49859539066540937
415,indian,7723,5816,3821,17360,0.3086365123567471,0.27535993204932535,0.4160035555939274
416,indians,16152,10408,5336,31896,0.37545729390778876,0.28662667345884396,0.33791603263336717
417,indictment,1153,244,258,1655,0.5375424659101212,0.1347684949590574,0.3276890391308214
418,infamous,1683,948,149,2780,0.5239665404665551,0.34965750640762727,0.12637595312581773
419,inferior,4047,2604,2219,8870,0.3071195031679774,0.23411554544101326,0.4587649513910093
420,inflicted,1469,422,257,2148,0.5503723023226804,0.1873105784299092,0.2623171192474104
421,information,9009,30822,6095,45926,0.1450044212831169,0.5877336461888605,0.26726193252802266
422,informed,12941,24908,3579,41428,0.24791036983101392,0.5653023529809682,0.18678727718801785
423,infringed,272,142,119,533,0.35582322130601246,0.22007403565667402,0.42410274303731355
424,inhabitant,1182,880,1649,3711,0.1759724076857897,0.15521184158843634,0.6688157507257739
425,inspection,1392,2608,810,4810,0.2081200442971593,0.4619525210036104,0.3299274346992303
426,insure,614,938,284,1836,0.24570086474625644,0.4446888418947201,0.3096102933590235
427,insurrections,452,324,199,975,0.3280141898824246,0.2785571350855615,0.3934286750320139
428,intents,478,198,1544,2220,0.09717559967528909,0.047688054272906684,0.8551363460518042
429,into,129955,85386,40635,255976,0.3801896446241241,0.2959436590815561,0.3238666962943198
430,invaded,1014,510,226,1750,0.45391396594543487,0.27047108699777034,0.2756149470567948
431,invasion,1519,1828,824,4171,0.25617640449794654,0.3652351974560669,0.37858839804598643
432,invasions,328,238,204,770,0.28136995911070206,0.24187775046375937,0.47675229042553857
433,inventors,114,50,32,196,0.43776401737119675,0.2274679922500212,0.33476799037878197
434,is,750507,630928,164361,1545796,0.3857157473550774,0.3841558968770959,0.23012835576782675
435,issue,4035,6010,6747,16792,0.13661216100535187,0.24106567395005357,0.6223221650445946
436,it,746474,759384,233307,1739165,0.3271520812271125,0.3942861521255723,0.2785617666473152
437,its,97248,57032,17228,171508,0.4592596370252307,0.31908859490986635,0.22165176806490297
438,jeopardy,128,188,67,383,0.24003447572176873,0.4176731741896677,0.3422923500885637
439,journal,1241,2160,2907,6308,0.10589097751276323,0.21835141323820845,0.6757576092490283
440,judge,15516,16170,9772,41458,0.25313652440029366,0.31253606650170646,0.43432740909799983
441,judges,6821,5096,5161,17078,0.25339394309402924,0.22428110107971394,0.5223249558262568
442,judgment,15080,10118,11259,36457,0.26117012391272854,0.20760217954789847,0.531227696539373
443,judicial,1597,1386,2845,5828,0.1453176117468678,0.14941412159733813,0.7052682666557941
444,junction,601,1502,86,2189,0.22985088592027245,0.6805448044209143,0.08960430965881332
445,jurisdiction,4141,3028,2447,9616,0.2876743775865674,0.2492108247848436,0.4631147976285889
446,jury,3712,1930,4558,10200,0.20156413695351133,0.12415885100713074,0.6742770120393579
447,just,34447,28686,5081,68214,0.41868574300966394,0.413068275698931,0.1682459812914051
448,justice,25445,17752,9420,52617,0.3527206093498011,0.2915350329462428,0.3557443577039562
449,keep,18310,15408,5217,38935,0.36059678370406184,0.35949665545744525,0.2799065608384931
450,kind,26903,27216,4252,58371,0.38036130986980293,0.45586368732503774,0.16377500280515936
451,king,38725,19390,7367,65482,0.4736030885129905,0.2809415593456478,0.2454553521413617
452,labor,10569,4910,2007,17486,0.4836255381413901,0.2661778423156151,0.2501966195429948
453,laid,16317,11772,26625,54714,0.1587278015952245,0.13566818695636523,0.7056040114484103
454,land,39771,24964,19464,84199,0.3249993658573081,0.24168252886086014,0.4333181052818317
455,lands,14239,13908,19699,47846,0.16874348397561026,0.1952662939307158,0.6359902220936741
456,large,33736,20376,4497,58609,0.48106934773682375,0.34422951891110753,0.1747011333520687
457,law,44442,28388,36410,109240,0.25070738975960294,0.1897244999499238,0.5595681102904733
458,laws,28216,17858,20776,66850,0.26625586745063445,0.1996418745696332,0.5341022579797322
459,lay,18139,11546,5715,35400,0.38278214367382757,0.2886589069003072,0.3285589494258651
460,least,24925,26776,4758,56459,0.3580697185625254,0.4557148778505443,0.1862154035869303
461,legislation,1118,978,560,2656,0.2940344287519309,0.3047265653307668,0.40123900591730216
462,legislative,3958,4116,4636,12710,0.18439950522712298,0.22718225589693056,0.5884182388759465
463,legislature,8765,11632,8074,28471,0.19678130123221008,0.30938651550039536,0.4938321832673946
464,legislatures,1161,2000,2050,5211,0.1273682645127444,0.2599405821710591,0.6126911533161965
465,letters,11164,44170,5667,61001,0.1414386502754801,0.6629652344170174,0.19559611530750257
466,levying,658,330,779,1767,0.20749208345387868,0.12328341552322318,0.6692245010228981
467,liable,3960,3670,5897,13527,0.16247317717712698,0.17838881953457641,0.6591380032882966
468,liberty,31356,29454,5687,66497,0.3835881553222448,0.42687811982624424,0.189533724851511
469,life,66511,17988,3463,87962,0.6838752246956632,0.21911966329507493,0.09700511200926186
470,like,51249,21626,9364,82239,0.5005748872375106,0.2502504927676166,0.2491746199948729
471,likewise,13720,6090,1475,21285,0.5498268150389056,0.2891373377351347,0.16103584722595973
472,limb,702,182,151,1035,0.528220031835899,0.16224234803562923,0.30953762012847175
473,limitations,370,446,481,1297,0.16751297489552747,0.2392195483722261,0.5932674767322464
474,limited,3014,2666,3008,8688,0.20978302912928354,0.2198377797352463,0.5703791911354701
475,list,3582,7062,1599,12243,0.219691602412457,0.5131338542217022,0.2671745433658408
476,longer,12733,10512,2675,25920,0.39209437402393704,0.38349552811356913,0.22441009786249383
477,made,103529,97802,50720,252051,0.28953125485029724,0.32403822871647353,0.3864305164332293
478,magazines,555,2494,507,3556,0.11347559418473105,0.6041169367430158,0.2824074690722531
479,maintain,4746,2764,1632,9142,0.38069545719490316,0.2626655275474148,0.35663901525768216
480,majority,4160,7196,4203,15559,0.17235974625240535,0.35322281732565564,0.4744174364219391
481,make,69913,76374,25900,172187,0.30271309478001157,0.39177244477306583,0.3055144604469226
482,manner,38951,25964,19493,84408,0.31714853385566694,0.2504556173125882,0.4323958488317448
483,maritime,837,1450,699,2986,0.18770419308666433,0.3852401991180454,0.4270556077952901
484,marque,578,472,334,1384,0.2823490987892757,0.27315908303196096,0.4444918181787633
485,maryland,5901,9438,6779,22118,0.16598893498650497,0.31452022441784033,0.5194908405956548
486,massachusetts,5813,10212,6871,22896,0.15869431274957094,0.3302835364940343,0.5110221507563947
487,may,210829,248500,92054,551383,0.278868290412003,0.38941283219102546,0.33171887739697153
488,measures,10984,21952,5441,38377,0.21198911407407034,0.5019289087944273,0.28608197713150224
489,meet,14402,14272,3979,32653,0.34168135039885056,0.4011422308270947,0.2571764187740547
490,meeting,20858,11254,5378,37490,0.4270484516688229,0.2729772657415974,0.2999742825895796
491,member,6364,5984,4996,17344,0.2351456583821941,0.2619470178132304,0.5029073238045755
492,members,15210,12592,10016,37818,0.2649142719469676,0.25982799202740453,0.4752577360256279
493,mentioned,18328,24928,15061,58317,0.2061834827598549,0.33223188565979384,0.4615846315803513
494,migration,192,72,125,389,0.3107599671802019,0.13806112715066193,0.5511789056691362
495,miles,20302,12118,2564,34984,0.48751809797182816,0.34474497712300795,0.1677369249051639
496,militia,6062,19422,7889,33373,0.11988816738111756,0.4550607931274694,0.42505103949141315
497,ministers,10422,8512,2408,21342,0.38505172203068794,0.3725758459215133,0.24237243204779857
498,misdemeanors,230,164,255,649,0.2055413257403026,0.17363219100708902,0.6208264832526084
499,mode,6987,10628,4535,22150,0.2188019048250973,0.39430018521350196,0.3868979099614008
500,monday,6803,6340,4528,17671,0.25527346026006137,0.28184447925593203,0.4628820604840067
501,money,26499,43880,25594,95973,0.17879265990254825,0.3507534078623831,0.4704539322350687
502,more,160734,139138,27245,327117,0.4020384993247235,0.4123070179953973,0.18565448267987902
503,most,111002,173332,12799,297133,0.3160467370326431,0.584674745519164,0.09927851744819294
504,my,282456,392154,9501,684111,0.3654345684494682,0.6010776114629175,0.03348782008761442
505,names,6989,5294,3742,16025,0.2979708006359358,0.2673977105029774,0.43463148886108693
506,nations,19836,15752,6984,42572,0.3448278265518647,0.32441355223912777,0.3307586212090075
507,natural_born,117,76,99,292,0.24541336511506578,0.18886045043365557,0.5657261844512788
508,naturalization,201,240,558,999,0.10022412781476986,0.14177594473404762,0.7579999274511825
509,nature,47776,18488,6308,72572,0.5500085379501392,0.2521533008506818,0.197838161199179
510,naval,1809,5062,3331,10202,0.10716337939019252,0.3552589718926375,0.5375776487171701
511,navy,1999,4652,2169,8820,0.1489637983133139,0.41069813388692994,0.44033806779975615
512,nays,604,176,3780,4560,0.05436321174323187,0.018767045888456554,0.9268697423683115
513,necessary,35090,54316,17632,107038,0.23793954474596704,0.43634109565170587,0.3257193596023271
514,needful,1398,686,273,2357,0.4731833745510913,0.27508157452788307,0.2517350509210257
515,neither,19813,11032,2243,33088,0.5081107138979616,0.33517949796465296,0.1567097881373854
516,net,747,690,948,2385,0.1801252355553333,0.19711429940286668,0.6227604650418
517,nevertheless,3459,3212,1659,8330,0.2935343933625993,0.3229230527435806,0.38354255389382025
518,new,59784,49410,16256,125450,0.36765823264700653,0.3599890244093478,0.2723527429436456
519,new_hampshire,2898,3322,4487,10707,0.15206471707256533,0.20651175871927696,0.6414235242081577
520,new_jersey,5664,5572,5410,16646,0.2097479291350094,0.24445595701994632,0.5457961138450442
521,new_york,17649,41948,9453,69050,0.189573215477906,0.5338057072643013,0.2766210772577927
522,next,36281,30498,19452,86231,0.2893081295450095,0.288116299909194,0.4225755705457965
523,nine,7292,5548,5791,18631,0.2460074690266297,0.2217446576204408,0.5322478733529294
524,ninth,1496,772,1033,3301,0.2863251568978332,0.17504926607572513,0.5386255770264416
525,no,207368,170764,89766,467898,0.3169664908090401,0.30923099080750527,0.37380251838345474
526,nobility,1596,658,216,2470,0.5384617984414515,0.26300438175460517,0.19853381980394333
527,nominate,318,1342,838,2498,0.07587913662237274,0.3793698882347494,0.544750975142878
528,nor,54875,30956,10577,96408,0.45590756194786153,0.3046927920871829,0.2393996459649556
529,north_carolina,2350,3528,6252,12130,0.0997361918762334,0.1773897722954955,0.7228740358282711
530,not,482461,468180,127233,1077874,0.34866290353602325,0.40084038185736814,0.25049671460660855
531,nothing,38344,37226,5564,81134,0.39285090132807043,0.45184740350252606,0.15530169516940362
532,notwithstanding,9732,7708,3296,20736,0.34952904330093504,0.32797289553883224,0.32249806116023283
533,now,107846,94810,19307,221963,0.39537678506088475,0.411790525908845,0.1928326890302702
534,number,33461,37028,12187,82676,0.3027320635915788,0.3968851417680861,0.3003827946403351
535,numbers,7194,7854,1544,16592,0.3474500703828778,0.4493947013593933,0.20315522825772905
536,numerous,7271,4442,763,12476,0.49759866032228806,0.36014608000597204,0.14225525967173996
537,oath,5422,2854,10571,18847,0.14419440552057242,0.08992034127001178,0.7658852532094158
538,objections,3216,4134,1893,9243,0.2423370996341746,0.3690535762159956,0.3886093241498297
539,obligation,3454,3418,1738,8610,0.28223008093202534,0.33087816269178866,0.386891756376186
540,obliged,13988,24800,3322,42110,0.2668487036014247,0.5605007970667357,0.1726504993318394
541,obtaining,2650,4904,1517,9071,0.21044008941024742,0.4613687184279882,0.32819119216176434
542,occasions,5283,4876,806,10965,0.39855180764491666,0.43579570884466073,0.16565248351042264
543,of,3531079,2977400,1483137,7991616,0.3181437528641803,0.31781049140442286,0.36404575573139675
544,offense,4693,2354,5751,12798,0.20272651923155421,0.12047073168792032,0.6768027490805255
545,offenses,1967,872,1520,4359,0.2754498194170909,0.14466707381789845,0.5798831067650106
546,office,17083,35196,21653,73932,0.14505376024748182,0.3540570445128949,0.5008891952396233
547,officer,9472,26928,15248,51648,0.114238045752298,0.3847585278914417,0.5010034263562603
548,officers,18784,55700,21252,95736,0.131660348040721,0.4625271115474897,0.4058125404117893
549,offices,4705,6472,4128,15305,0.19920820129053607,0.3246393611328847,0.4761524375765792
550,on,449189,436218,193629,1079036,0.3007641412903309,0.34603147655772365,0.3532043821519455
551,once,24973,13644,2652,41269,0.5163743287626689,0.3342340697342673,0.14939160150306385
552,one,201498,157248,79403,438149,0.3335440751702922,0.3083775127472622,0.3580784120824456
553,only,101814,84066,19490,205370,0.4000462117362169,0.3913254791352262,0.208628309128557
554,open,16961,11256,3267,31484,0.4327166021552701,0.34021328513419336,0.22707011271053665
555,opinion,20695,44270,11390,76355,0.19866082525040743,0.5034674599670752,0.2978717147825173
556,or,435793,303232,382636,1121661,0.23717117911544203,0.19551125933810912,0.5673175615464487
557,ordain,932,184,266,1382,0.4971572658356755,0.11628154182725388,0.38656119233707076
558,order,42907,51474,25972,120353,0.24568077882290767,0.34917732063536816,0.40514190054172416
559,organizing,130,298,267,695,0.10739891664081061,0.29166740144376485,0.6009336819154246
560,original,7248,6672,4748,18668,0.2580504589992303,0.2814216914131722,0.46052784958759757
561,originate,586,362,249,1197,0.346085204175025,0.25328476466986727,0.4006300311551077
562,originated,920,710,325,1955,0.34762169054112796,0.3178282295819421,0.33455007987692986
563,other,146431,133408,69702,349541,0.2961955531009256,0.31969986970184744,0.38410457719722707
564,others,43056,31784,9589,84429,0.40301540190684787,0.3524614271947511,0.24452317089840092
565,otherwise,11436,11324,6288,29048,0.27240052424993516,0.3195572926991998,0.40804218305086504
566,our,244790,215528,35410,495728,0.4103096080057704,0.427993125509479,0.16169726648475063
567,ourselves,13466,8016,1326,22808,0.5067138839444012,0.35735262988081284,0.13593348617478596
568,out,97696,75094,33302,206092,0.35220150008488665,0.3207264203802198,0.32707207953489353
569,over,49721,26614,8349,84684,0.47810275867268487,0.3031842437009228,0.21871299762639237
570,overt,210,100,130,440,0.3076319398837147,0.17355103557042703,0.5188170245458583
571,own,81688,51914,11964,145566,0.4647033166729139,0.3498783596968228,0.18541832363026337
572,owner,7038,1594,6110,14742,0.275222256492026,0.07384782109918576,0.6509299224087883
573,paid,20556,24550,25122,70228,0.17408345280109375,0.2463119369753393,0.579604610223567
574,papers,6916,25470,17634,50020,0.08123902318276083,0.3544489818987732,0.564311994918466
575,pardons,305,206,95,606,0.37753938773076523,0.30209582844683674,0.3203647838223979
576,part,72524,68122,30126,170772,0.30821620571813524,0.3429858398481439,0.34879795443372075
577,particular,22169,27630,6212,56011,0.3086475387486435,0.4557353111031497,0.23561715014820678
578,particularly,13440,16038,2698,32176,0.33776705212562635,0.47751091593958883,0.18472203193478492
579,parts,22725,13388,5203,41316,0.4307186034535133,0.3006218353597597,0.2686595611867269
580,party,14246,18800,9010,42056,0.2332929231579398,0.36473845503522634,0.4019686218068338
581,pass,13457,12446,4770,30673,0.32664977447206184,0.35791424773391534,0.31543597779402277
582,passed,16758,14000,20117,50875,0.19010932574670475,0.18815872052662233,0.6217319537266729
583,pay,21671,36218,33185,91074,0.13982570076329714,0.2768519564293189,0.5833223428073838
584,payment,7743,14040,12559,34342,0.1321528884175716,0.2838896689621988,0.5839574426202296
585,peace,32801,28022,17852,78675,0.2861372355095147,0.2896019631671482,0.4242608013233371
586,peaceably,773,288,189,1250,0.4744962646052126,0.2094405992342436,0.3160631361605437
587,penalties,1341,780,3111,5232,0.12485508262691128,0.08603737098113895,0.7891075463919498
588,pennsylvania,15304,11074,9968,36346,0.2753526768519359,0.23604996755669794,0.48859735559136613
589,people,91712,52550,15350,159612,0.46842666815356304,0.3179825209755612,0.21359081087087586
590,perfect,10694,11938,835,23467,0.39443822255105065,0.5216575146791389,0.0839042627698104
591,period,9923,9560,2461,21944,0.3549827932386124,0.4051700018443083,0.23984720491707928
592,person,40607,30704,40037,111348,0.2182510901794868,0.19550845948651624,0.586240450333997
593,persons,41933,23948,33134,99015,0.2611470289168458,0.17669061592136506,0.5621623551617891
594,petition,4957,5464,22192,32613,0.06895400894546594,0.09004640373958037,0.8409995873149537
595,piracies,131,162,148,441,0.18040988518104858,0.2643133682207561,0.5552767465981954
596,place,59774,66616,19906,146296,0.30982930970521416,0.4090758221553748,0.281094868139411
597,places,15361,11088,5415,31864,0.3551728052891684,0.30373057596610276,0.3410966187447289
598,plantations,3159,1118,1349,5626,0.3871974590435196,0.16234531356686197,0.45045722738961846
599,ports,4052,7450,3360,14862,0.183915314653813,0.40060817792442144,0.4154765074217656
600,post,5650,27272,4548,37470,0.11221480780113514,0.6417025874230952,0.2460826047757697
601,posterity,4208,1606,296,6110,0.6083511768636101,0.27506747599671827,0.11658134713967165
602,power,63908,49262,24043,137213,0.34035163520381795,0.3108134005719571,0.34883496422422494
603,powers,15673,18360,10088,44121,0.241467050707278,0.33511471709702284,0.42341823219569913
604,preference,1695,2910,687,5292,0.2416546931281613,0.4915114059000223,0.2668339009718163
605,prejudice,3376,2238,717,6331,0.4230184341471667,0.3322247762701172,0.24475678958271613
606,prescribe,681,566,239,1486,0.3400470677177597,0.3348292835324211,0.32512364874981914
607,prescribed,1928,1730,1999,5657,0.20459519941777904,0.21749515801894123,0.5779096425632797
608,presence,8299,3440,1070,12809,0.542792318479185,0.26655169651429406,0.1906559850065208
609,present,50065,82728,20777,153570,0.24460413854797994,0.47884745708023996,0.2765484043717801
610,presented,6393,7326,3286,17005,0.26610474630321207,0.3612683460056901,0.37262690769109785
611,presentment,151,110,369,630,0.11736409393345307,0.10128988271100707,0.7813460233555399
612,preserve,6558,4546,1084,12188,0.4402259291053113,0.36153364339496286,0.19824042749972587
613,preserved,4631,1916,543,7090,0.5526102604206454,0.27086615825301374,0.1765235813263408
614,preside,692,528,219,1439,0.3615166247680059,0.3267918235431016,0.3116915516888925
615,president,12599,37738,18864,69201,0.11590665092794057,0.4113071332982772,0.47278621577378216
616,press,4658,4146,889,9693,0.3884332027576439,0.4096012179756825,0.20196557926667347
617,prevent,13214,17244,6454,36912,0.25795460291255723,0.3988063580860486,0.3432390390013942
618,previously,1992,2710,943,5645,0.25631708755364513,0.4131165526674708,0.33056635977888416
619,prince,10882,4568,1497,16947,0.5341617646438993,0.2656472055136695,0.2001910298424312
620,principal,9858,10832,4693,25383,0.2778770613876894,0.36173257095141276,0.36039036766089794
621,prior,1141,1816,1068,4025,0.18397213325173442,0.34689442804523557,0.46913343870303004
622,private,14009,19852,5572,39433,0.26578528464023404,0.4462139500915837,0.28800076526818225
623,privilege,4087,1864,1588,7539,0.3847840858789615,0.20790907791923322,0.40730683620180536
624,privileged,279,204,96,579,0.35667823663628606,0.30897095491576504,0.334350808447949
625,privileges,6676,2630,2417,11723,0.4076573182479024,0.19026098627873433,0.40208169547336325
626,pro,750,738,3358,4846,0.0696210649905314,0.08116164501322949,0.8492172899962391
627,probable,5193,10432,1294,16919,0.2463793208436017,0.5863657427685915,0.16725493638780667
628,proceed,10060,11972,5754,27786,0.25200901704482187,0.3553038291167011,0.392687153838477
629,proceedings,6108,9324,6722,22154,0.17221536745921,0.3114513510866896,0.5163332814541005
630,process,2345,1866,3336,7547,0.17187005743986195,0.1620257701874459,0.6661041723726923
631,produce,12405,11830,4483,28718,0.32109554316052635,0.36277498568817523,0.3161294711512984
632,profit,3407,2776,829,7012,0.3804900358715927,0.3672871179705203,0.252222846157887
633,progress,6762,5998,1305,14065,0.38810360296091095,0.4078439737373587,0.2040524233017303
634,prohibited,1450,1240,864,3554,0.27499274053709843,0.2786056966207607,0.4464015628421409
635,prohibiting,414,540,307,1261,0.2190342582008496,0.3384702834064005,0.44249545839274995
636,promote,5915,4654,1182,11751,0.40378652562097533,0.3763903951885923,0.21982307919043237
637,proper,28109,42532,15242,85883,0.23419954717085195,0.41982813605805347,0.3459723167710947
638,property,20682,16154,10667,47503,0.30026000980024437,0.27784342201979934,0.42189656817995635
639,proportion,9398,9808,5767,24973,0.2558748542306986,0.31636447119350014,0.4277606745758013
640,propose,2720,7656,995,11371,0.1875744969188247,0.6254921896359664,0.18693331344520886
641,proposed,9298,16458,7399,33155,0.18993586903696524,0.39829933783427235,0.4117647931287623
642,proposing,507,1370,385,2262,0.15948769149742884,0.5105694907067033,0.3299428177958679
643,prosecutions,460,374,415,1249,0.22619105164339828,0.2178734298878503,0.5559355184687514
644,protect,2799,2498,815,6112,0.35080682362663584,0.370913506417462,0.27827966995590203
645,proved,8236,3436,2532,14204,0.4288538006336785,0.2119635383001617,0.3591826610661597
646,provide,3576,5074,4219,12869,0.16962995022343252,0.2851481560323122,0.5452218937442552
647,provided,9020,11130,17050,37200,0.13138032776942452,0.1920587278517394,0.6765609443788361
648,providence,12675,5930,1190,19795,0.5524723491108341,0.30621915389338894,0.14130849699577705
649,public,57854,62952,29534,150340,0.2717495395500969,0.35031605218037043,0.3779344082695326
650,public_use,141,358,196,695,0.12828717517362712,0.3858888555311477,0.48582396929522514
651,publish,2000,1874,492,4366,0.3596779860056393,0.39927169982575217,0.24105031416860853
652,published,8804,5392,1252,15448,0.47326070761856864,0.34338820888362054,0.1833510834978109
653,punish,2511,1004,605,4120,0.4694622321181976,0.2223835913438112,0.30815417653799115
654,punishment,9155,2858,1785,13798,0.52603324772148,0.19455040997144774,0.27941634230707213
655,punishments,1782,414,234,2430,0.612378468934516,0.16854956426029674,0.21907196680518737
656,purchased,3514,4714,2120,10348,0.23624595937847118,0.3754631249336095,0.38829091568791924
657,purpose,23666,28990,13016,65672,0.2531914203273357,0.3674408358086786,0.3793677438639858
658,purposes,7368,8002,6485,21855,0.21347020259947153,0.2746637038208837,0.5118660935796449
659,pursuance,1354,1490,2211,5055,0.14809612865812985,0.1930751540512422,0.658828717290628
660,put,39783,30714,8093,78590,0.4050463478440785,0.37047478176636683,0.22447887038955464
661,qualification,827,432,421,1680,0.3326978899338311,0.20589384490378906,0.46140826516237976
662,qualifications,1555,1420,538,3513,0.3306409895015403,0.35770888129804046,0.3116501292004193
663,quartered,474,456,156,1086,0.32934367771066553,0.3753625250495736,0.2952937972397609
664,question,13832,17290,12976,44098,0.1985456295481679,0.2940257894754574,0.5074285809763748
665,questioned,827,482,182,1491,0.4366740415315892,0.3015185142481256,0.26180744422028535
666,quorum,635,334,783,1752,0.2007053770691624,0.12506817981119903,0.6742264431196386
667,raise,6914,5390,2149,14453,0.360965154961913,0.333380159662778,0.3056546853753089
668,raising,3569,3848,2055,9472,0.26001215426620916,0.33212169447854445,0.40786615125524633
669,ratification,708,2238,933,3879,0.1199757276651073,0.4492988398905187,0.43072543244437395
670,ratified,975,1096,1063,3134,0.18860962344422952,0.2511798903585987,0.5602104861971717
671,ratifying,132,192,186,510,0.1523914819165797,0.26260504782949523,0.5850034702539251
672,rebellion,2542,774,410,3726,0.5555137039864023,0.2003896430022935,0.24409665301130418
673,receipts,648,1918,2179,4745,0.07316584619583748,0.2565648027860173,0.6702693510181452
674,receive,21107,33322,12547,66976,0.22272691803172828,0.41657416988512264,0.360698912083149
675,recess,715,822,676,2213,0.20252195940904674,0.27583728935347535,0.5216407512374778
676,recommend,4020,7950,1110,13080,0.24419120119901522,0.5721187312347354,0.18369006756624925
677,reconsider,113,260,225,598,0.10928437298505649,0.2978983168495511,0.5928173101653925
678,reconsideration,100,302,165,567,0.11021732785488939,0.3943409702592824,0.49544170188582826
679,reconsidered,73,128,163,364,0.1091656155570034,0.22677128321933873,0.6640631012236579
680,records,1761,1432,2874,6067,0.15601711269084093,0.15030415227921093,0.6936787350299481
681,redress,2310,2214,757,5281,0.3302226931974795,0.374962323584713,0.29481498321780736
682,reexamined,27,38,14,79,0.24509842200801554,0.4086725123758785,0.34622906561610595
683,regular,5105,6550,1594,13249,0.29667336190713517,0.4509612096019815,0.2523654284908834
684,regulate,1824,1836,2044,5704,0.19064221160718828,0.22734321141919675,0.5820145769736149
685,regulated,1603,1330,992,3925,0.272563210846812,0.26791710104775146,0.45951968810543653
686,regulation,1657,2660,1861,6178,0.16774111933439742,0.3190169400267128,0.5132419406388897
687,regulations,3217,5102,3658,11977,0.1673167133357615,0.3143719568636426,0.5183113298005958
688,relating,2469,3464,1900,7833,0.21014412412015757,0.3492923906409904,0.4405634852388521
689,religion,27108,2804,831,30743,0.8291464332121833,0.1016077534585336,0.0692458133292832
690,religious,11383,1636,952,13971,0.7152481905472929,0.12178629299274277,0.16296551645996432
691,remain,10289,20062,4582,34933,0.22108021142303466,0.5107001790971282,0.2682196094798371
692,removal,2147,3508,1979,7634,0.18359169781726686,0.35538218928679005,0.46102611289594314
693,removed,7473,6064,2889,16426,0.3317248962782766,0.3189020840553697,0.3493730196663537
694,repassed,66,26,10,102,0.5320610586517786,0.24831672211061637,0.21962221923760525
695,repel,874,604,374,1852,0.3350627072274544,0.27432581569444414,0.3906114770781014
696,representation,3561,4904,2539,11004,0.21862832905549195,0.3566974490436052,0.424674221900903
697,representative,1855,2164,1460,5479,0.22093214353890112,0.30534255040812214,0.47372530605297675
698,representatives,9388,9474,12412,31274,0.17249004701947204,0.20622410150574375,0.6212858514747842
699,reprieves,64,16,44,124,0.31554180026972767,0.09345703267097664,0.5910011670592957
700,reprisal,146,280,210,636,0.1390702509914268,0.3159762889256763,0.5449534600828969
701,republican,2272,3456,660,6388,0.2782799539547043,0.501490152775131,0.22022989327016465
702,require,7445,11718,4474,23637,0.22213169517094294,0.4142041086745931,0.363664196154464
703,required,9309,8662,13797,31768,0.1628628419961303,0.17953628656863593,0.6576008714352337
704,requisite,2692,4258,1119,8069,0.2496048060104601,0.46773366022767815,0.28266153376186176
705,reserved,2103,1824,1181,5108,0.28109890197300547,0.28884163225847304,0.4300594657685215
706,reserving,374,604,295,1273,0.1975443891225224,0.3779593690854388,0.42449624179203876
707,resident,804,1336,1114,3254,0.14829350725989385,0.29193598184497777,0.5597705108951284
708,resignation,1802,3064,674,5540,0.24793032441433963,0.4994346883237058,0.25263498726195455
709,resolution,8388,10320,11259,29967,0.1635487666783077,0.2383875822639411,0.5980636510577512
710,respect,20788,67480,5915,94183,0.17790761344352127,0.6841825284461901,0.1379098581102886
711,respecting,7128,20810,5128,33066,0.15579537921379447,0.5388576364933284,0.30534698429287727
712,respective,7094,7408,5105,19607,0.23822903563114567,0.2947267548907076,0.4670442094781468
713,respectively,2732,2278,3543,8553,0.1811302619023131,0.17892833467827665,0.6399414034194102
714,retained,1650,1480,711,3841,0.3089669342212148,0.3283256817882646,0.36270738399052077
715,return,22178,43186,8229,73593,0.23160054949635397,0.5342878113962684,0.23411163910737778
716,returned,14014,11230,3884,29128,0.3697658507555837,0.35104235802233064,0.27919179122208565
717,returning,3657,4206,1146,9009,0.31091650706292007,0.42364605649800935,0.26543743643907064
718,returns,3113,7894,1971,12978,0.17454631158793446,0.5243771483173868,0.30107654009467866
719,revenue,3760,7802,4987,16549,0.14140986766071637,0.3476265168942871,0.5109636154449966
720,revision,310,744,362,1416,0.14235623096652014,0.4047648609567207,0.4528789080767591
721,rhode_island,3334,6840,3640,13814,0.15612991296583828,0.3794824570951805,0.46438762993898125
722,right,39270,27488,15622,82380,0.34328446552342434,0.28467640444906384,0.3720391300275118
723,rights,16052,10486,6211,32749,0.35360152965948327,0.2736591145744727,0.37273935576604406
724,roads,2572,3476,3618,9666,0.15543899496824007,0.2488764842854206,0.5956845207463394
725,rule,9107,5544,4061,18712,0.3405942926384917,0.2456407028099642,0.4137650045515441
726,rules,5825,3596,4215,13636,0.27007263274274723,0.1975237906609274,0.5324035765963253
727,s,241416,199006,79317,519739,0.348229350513979,0.34007959406718735,0.3116910554188337
728,safety,8496,7142,2685,18323,0.3500319880254781,0.34860062129087743,0.30136739068364443
729,said,146991,63128,165334,375453,0.21867046645732208,0.11125934460988353,0.6700701889327944
730,same,101040,76862,27886,205788,0.37691604100090126,0.33968630990699994,0.28339764909209875
731,science,4009,1898,189,6096,0.5919534092013088,0.33201886302156697,0.0760277277771242
732,sealed,1299,896,625,2820,0.3196979743796932,0.2612485106334739,0.4190535149868329
733,searched,611,270,99,980,0.5089198436948238,0.2664323890947168,0.22464776721045943
734,searches,221,90,49,360,0.4792714938869059,0.23123145642200466,0.28949704969108947
735,seas,2583,1650,848,5081,0.37718977236544693,0.28545294390447096,0.33735728373008206
736,seat,6309,4824,2095,13228,0.3558066710228401,0.3223116015984223,0.32188172737873755
737,seats,1456,672,433,2561,0.4242717343308696,0.23198883153408587,0.34373943413504443
738,second,24861,14650,9916,49427,0.35909944946454964,0.25069683465382175,0.3902037158816287
739,secrecy,1058,1382,327,2767,0.29502518368156294,0.4565586178949015,0.24841619842353557
740,section,3560,2660,4571,10791,0.1857626980205785,0.16443915214357552,0.6497981498358459
741,secure,7924,7206,2340,17470,0.3469960075230707,0.3738430824254046,0.2791609100515246
742,securing,1879,1850,1118,4847,0.2640334381441733,0.3079774787668505,0.4279890830889761
743,securities,725,1094,1755,3574,0.10658206468563607,0.19053664970538006,0.7028812856089839
744,security,8929,9242,5865,24036,0.24902161160448397,0.30536218936526266,0.44561619903025335
745,seized,7142,1910,1746,10798,0.5043257707182895,0.1597863816704654,0.33588784761124496
746,seizures,166,160,126,452,0.23754337925582136,0.2712500988187781,0.49120652192540043
747,senate,6161,12494,17660,36315,0.08919364284384206,0.2142887021940619,0.696517654962096
748,senator,510,826,589,1925,0.16487758098789707,0.3163636360312102,0.5187587829808928
749,senators,1401,1492,1278,4171,0.21066764563327312,0.2657930432014724,0.5235393111652545
750,sent,25431,52536,5816,83783,0.24567210522275204,0.6012630186410137,0.15306487613623412
751,service,16517,38094,12246,66857,0.17384535725380892,0.4750109110940015,0.3511437316521896
752,services,4974,11038,5406,21418,0.15174527672081553,0.3989466942862428,0.44930802899294175
753,session,2915,8120,6442,17477,0.09689211752693673,0.31975768976678004,0.5833501927062833
754,seven,13034,8042,13314,34390,0.221541758112719,0.16194107953227826,0.6165171623550028
755,several,43303,39286,20628,103217,0.2965081680727411,0.3186922988897681,0.38479953303749076
756,shall,181970,177154,136677,495801,0.23811829603046472,0.27463697942704585,0.4872447245424895
757,ships,10679,16778,3720,31177,0.26244334035904726,0.4884951322320607,0.24906152740889193
758,should,130136,166116,29105,325357,0.32035203553840685,0.4844584989565947,0.19518946550499844
759,sign,5197,2692,1019,8908,0.46558306542806704,0.2857160215805761,0.24870091299135685
760,signed,4910,6440,4000,15350,0.2094988657094485,0.3255375804039636,0.464963553886588
761,silver,7125,3288,1872,12285,0.4419896242158819,0.24164293085430846,0.3163674449298096
762,sitting,3610,2052,956,6618,0.4175584853617307,0.28119173289709726,0.30124978174117206
763,six,21495,15672,8567,45734,0.3390315066314177,0.2928478994317839,0.3681205939367984
764,sixth,3124,1354,1407,5885,0.3649007435169361,0.1873688828893694,0.44773037359369444
765,smaller,1886,1792,436,4114,0.3629142212051773,0.4085219383273057,0.22856384046751693
766,so,236868,179756,55780,472404,0.3936050885366068,0.35387736659509456,0.25251754486829864
767,soldier,4286,4342,2471,11099,0.2651923971959378,0.3182832628951913,0.41652433990887083
768,sole,2864,1994,1280,6138,0.32868677790383355,0.2711124455019046,0.40020077659426184
769,solemnly,1853,616,565,3034,0.44953584849861555,0.17704542284874206,0.3734187286526423
770,south_carolina,3418,4074,6691,14183,0.129112713820538,0.18231947265404413,0.688567813525418
771,speaker,3105,2122,2843,8070,0.2323367062540838,0.18811207905456906,0.5795512146913472
772,speech,5123,3358,1740,10221,0.37011597244537064,0.2874148766726201,0.3424691508820092
773,speedy,2607,3338,800,6745,0.2982479687417707,0.45241591679939236,0.24933611445883697
774,square,3805,3158,698,7661,0.40273421866727066,0.39599625251297516,0.2012695288197541
775,standard,2357,2004,614,4975,0.36805637661064017,0.3707383912537443,0.26120523213561564
776,state,75477,97886,60323,233686,0.21214292752738112,0.32594895264127105,0.46190811983134783
777,stated,3661,6190,2934,12785,0.1928103262160555,0.38622136073718516,0.42096831304675936
778,statement,1001,4362,1367,6730,0.10118376139847983,0.5223691056367215,0.3764471329647986
779,states,17647,48310,30036,95993,0.11261033398803821,0.3652241427687869,0.5221655232431749
780,subject,31333,54212,12846,98391,0.2399973457477803,0.49194320891464904,0.26805944533757076
781,subjects,16380,11116,2885,30381,0.43786251716744,0.35203633433189696,0.210101148500663
782,subsequent,2023,3056,1194,6273,0.2273968412274908,0.40696491976739024,0.3656382390051191
783,such,158757,125780,127501,412038,0.24233089696886514,0.22745871260350628,0.5302103904276286
784,sufficient,17787,18046,9289,45122,0.2758843393142804,0.3316044701111313,0.39251119057458816
785,suffrage,504,372,317,1193,0.27871082925051466,0.24371447659848106,0.4775746941510041
786,suits,1255,1622,2033,4910,0.14400188897583138,0.2204907593896514,0.6355073516345171
787,sundays,316,184,128,628,0.3579918678723431,0.24695565861031352,0.39505247351734346
788,support,17639,15656,7124,40419,0.3172765492076412,0.333626013310798,0.34909743748156075
789,supported,5603,4456,1503,11562,0.37411287584298514,0.3524863432611519,0.2734007808958629
790,suppress,1265,1004,346,2615,0.3723793776608352,0.35014174285976524,0.2774788794793996
791,supreme,8155,3112,5561,16828,0.3021287018166456,0.13659118967241934,0.5612801085109351
792,suspended,1935,2242,797,4974,0.2861399801762344,0.39277900144887323,0.3210810183748924
793,swear,2429,574,1015,4018,0.413501917610822,0.1157649225613396,0.4707331598278383
794,take,59602,71276,20801,151679,0.2969519020631293,0.4207108161163335,0.28233728182053724
795,taken,46989,51350,20527,118866,0.2869618962297271,0.37152116408078506,0.34151693968948776
796,tax,4734,4860,10876,20470,0.11799166751101581,0.14350744572962648,0.7385008867593578
797,taxed,1038,560,1230,2828,0.20544851874758793,0.13131331583371655,0.6632381654186955
798,taxes,5564,5772,8902,20238,0.15179737643939945,0.18656000587370075,0.6616426176868998
799,temporary,2267,3298,1174,6739,0.24187636217921243,0.41687671646578317,0.3412469213550043
800,tempore,88,144,115,347,0.15387394944830832,0.2983046346467993,0.5478214159048923
801,ten,17915,11854,9960,39729,0.3031666265330156,0.2376537008213128,0.4591796726456717
802,tender,9915,3546,1273,14734,0.5638624648977102,0.23890997249999674,0.19722756260229315
803,term,4644,5038,7432,17114,0.15048711147050992,0.19341062946313198,0.656102259066358
804,territory,2969,5130,4652,12751,0.1366932882664404,0.27981399914025945,0.5834927125933002
805,test,1468,634,365,2467,0.4568242589437945,0.2337369866317497,0.30943875442445584
806,testimony,7310,3094,1265,11669,0.506871963997931,0.2541653144458116,0.2389627215562575
807,than,124506,114542,26126,265174,0.3757178083386637,0.4094975819198867,0.21478460974144953
808,that,1012958,944706,376684,2334348,0.3207209869875127,0.35436244926840205,0.32491656374408534
809,the,5405108,4730840,2341025,12476973,0.31086116011554993,0.322340909998834,0.366797929885616
810,their,445060,272702,111062,828824,0.415670477803208,0.30174078803599075,0.2825887341608012
811,them,302718,236486,66782,605986,0.39580134098533826,0.3663190729659209,0.23787958604874068
812,themselves,46608,25330,6878,78816,0.48878497611308747,0.31470790436775953,0.196507119519153
813,then,108466,47164,24877,180507,0.46729411468163823,0.2407256663484651,0.2919802189698966
814,there,155782,148718,39257,343757,0.35492140318773086,0.4014149389110922,0.24366365790117686
815,thereby,6684,4572,2958,14214,0.3315627187969553,0.2686894118901215,0.39974786931292317
816,therein,7387,5714,11198,24299,0.16539247480063257,0.15156640956013046,0.683041115639237
817,thereof,14289,8714,32036,55039,0.12770683863334184,0.09226669269192103,0.7800264686747372
818,they,443912,297506,94608,836026,0.42112268386155893,0.3343663459616417,0.24451097017679943
819,thing,42953,38374,7645,88972,0.3931882604732962,0.41615890467964606,0.19065283484705778
820,things,45082,21252,4347,70681,0.5490956701847938,0.3066618362155381,0.14424249359966815
821,think,41521,76028,9568,127117,0.26335937829194306,0.5713071111365488,0.16533351057150822
822,third,14969,8156,9581,32706,0.2950527029995385,0.19045795039929106,0.5144893466011704
823,thirds,1501,1334,1701,4536,0.19454372713073273,0.20483654851256192,0.6006197243567053
824,thirty,8082,5112,7217,20411,0.23911437045619327,0.17918133027018715,0.5817042992736197
825,this,510558,481366,181143,1173067,0.32430108928279616,0.3622378384701183,0.31346107224708564
826,those,125603,92562,21369,239534,0.4279795613980214,0.3736550246819507,0.1983654139200279
827,thousand,19775,16708,18986,55469,0.21660957690459628,0.21682068320780248,0.5665697398876013
828,three,50890,38534,24320,113744,0.31259695725316716,0.28042160367649166,0.40698143907034123
829,throughout,4475,2452,1090,8017,0.43239045345087834,0.2806846114489935,0.2869249351001282
830,time,128498,135892,55324,319714,0.29190011555804224,0.36571844899810535,0.3423814354438524
831,times,22665,13390,4554,40609,0.44497934576897413,0.3114438696929852,0.24357678453804066
832,title,7249,3960,3873,15082,0.3222953702118004,0.2085865174182913,0.4691181123699083
833,to,2506012,2762734,983344,6252090,0.29628822363012625,0.38697721649806466,0.3167345598718091
834,together,25377,15072,7169,47618,0.4043257362693312,0.28449659434412417,0.3111776693865446
835,tonnage,588,1676,1703,3967,0.08151822018734482,0.27527480096997486,0.6432069788426802
836,training,265,236,270,771,0.20700521987402692,0.21840496448290514,0.5745898156430679
837,tranquility,3021,2324,447,5792,0.43206163359883143,0.3937732244033552,0.1741651419978132
838,transmit,1422,8322,1711,11455,0.08919530330985785,0.6184223571849319,0.29238233950521025
839,treason,2413,1142,1253,4808,0.3360946081705288,0.18844534216432052,0.47546004966515065
840,treasury,3487,20626,17376,41489,0.04633218971670006,0.324684063098103,0.628983747185197
841,treaties,2982,6216,4324,13522,0.134772441976952,0.332827761660836,0.5323997963622119
842,treaty,12119,26980,11608,50707,0.1600784077460368,0.42220463408535414,0.4177169581686091
843,trial,7814,6622,5617,20053,0.2523760662067538,0.2533838999603255,0.4942400338329206
844,tribes,2874,1448,917,5239,0.405492517286175,0.24203586378338193,0.352471618930443
845,tribunals,391,418,325,1134,0.22070226899777648,0.27952548039815306,0.49977225060407054
846,tried,4465,5276,2261,12002,0.2645883623501949,0.3703984341048022,0.3650132035450029
847,troops,13559,39790,5491,58840,0.17921388147385353,0.6230644958529928,0.19772162267315357
848,trust,11675,10870,2931,25476,0.35881255156981356,0.3957813828183521,0.24540606561183445
849,try,4383,3628,1793,9804,0.32309021283230926,0.3168361228947394,0.3600736642729513
850,twenty,17617,11198,14464,43279,0.25063988222225214,0.18874426597158117,0.5606158518061667
851,twice,3217,2330,1190,6737,0.34894041951937843,0.2994133904392376,0.351646190041384
852,two,95243,88260,37315,220818,0.31593450752907665,0.346851039497503,0.33721445297342034
853,under,77517,80330,32735,190582,0.29601763032154366,0.3634238861655665,0.3405584835128899
854,uniform,2034,2074,999,5107,0.282002374944528,0.34066353553498135,0.37733408952049063
855,union,10819,10548,5891,27258,0.2748422424612275,0.3174545555805056,0.40770320195826687
856,united_states,27064,54696,49847,131607,0.11887760878179142,0.28462872205230105,0.5964936691659074
857,unless,11966,16728,6974,35668,0.23562816990444171,0.3902449677749916,0.37412686232056663
858,unreasonable,1662,1106,404,3172,0.4080605225330803,0.3217094135167181,0.27023006395020155
859,until,15888,25392,13256,54536,0.19355781117758686,0.36648268503226195,0.4399595037901512
860,unusual,1343,624,162,2129,0.5321752736884278,0.29293977878617145,0.17488494752540085
861,up,89521,55602,16441,161564,0.4471928821369587,0.32906027096164825,0.22374684690139313
862,upon,157935,135016,49661,342612,0.34850116195713116,0.35296054646923014,0.2985382915736387
863,use,30741,24346,14764,69851,0.3080073236659778,0.2889919529671837,0.4030007233668385
864,useful,9900,10018,1186,21104,0.3960070395993149,0.47474873809556545,0.1292442223051197
865,vacancies,417,1322,725,2464,0.10534739475644431,0.39567105431595645,0.49898155092759916
866,vacated,178,128,206,512,0.19980812683552127,0.17022298258864632,0.6299688905758323
867,valid,658,616,1632,2906,0.1127893717406211,0.12509445984326964,0.7621161684161092
868,value,10406,11138,8524,30068,0.2222386970613026,0.28181113838208305,0.4959501645566143
869,vessels,16216,21070,7863,45149,0.25904413114797853,0.398758209659756,0.3421976591922654
870,vest,831,500,543,1874,0.28628843817644095,0.20407409062618295,0.509637471197376
871,vested,2214,2198,2206,6618,0.20447236288146514,0.24049152003698954,0.5550361170815452
872,vice_president,1073,1642,1225,3940,0.1688273811581285,0.30607749240119303,0.5250951264406784
873,violated,1384,786,491,2661,0.3788841540319879,0.2549223880942678,0.36619345787374435
874,virginia,9412,26536,9742,45690,0.13966454164924202,0.46650336473682347,0.39383209361393456
875,vote,3397,5176,5987,14560,0.13146473711547374,0.23731384624415383,0.6312214166403725
876,voted,1729,1962,1507,5198,0.21191391815387312,0.284890896080111,0.5031951857660159
877,votes,2485,3048,3136,8669,0.16974622381672191,0.24666286491436165,0.5835909112689164
878,voting,559,512,572,1643,0.20522128436616272,0.22268739475988994,0.5720913208739473
879,war,36056,64712,24400,125168,0.20121098218895223,0.427832762114587,0.37095625569646085
880,warrants,795,2292,2743,5830,0.0723833116189778,0.24722991150407503,0.6803867768769472
881,was,502746,304384,125638,932768,0.4169972381059888,0.29910347218034533,0.28389928971366585
882,water,34416,12830,2330,49576,0.6149710517378307,0.2716039091025594,0.11342503915960979
883,we,294468,230914,32320,557702,0.4488251842151306,0.41696966008990183,0.1342051556949675
884,weights,559,788,584,1931,0.18128378650422494,0.3027529987303931,0.5159632147653821
885,welfare,4007,3376,1136,8519,0.3609441413629462,0.36027835620812476,0.27877750242892907
886,well,88915,78722,12433,180070,0.41154842572898476,0.4316752122158114,0.15677636205520393
887,what,146448,101386,21402,269236,0.4507925652597923,0.3697314286732219,0.17947600606698566
888,whatever,14589,13006,3832,31427,0.3607829527392233,0.3810476732409258,0.25816937401985085
889,whatsoever,4771,1972,5046,11789,0.22877882560564528,0.11202846888084686,0.6591927055135078
890,when,178206,100104,28302,306612,0.4766078850160887,0.31717972082269213,0.20621239416121917
891,whenever,4456,5582,2323,12361,0.25612578523730606,0.38011327137613465,0.36376094338655945
892,where,83467,50448,25525,159440,0.3922836974143789,0.28089531082119085,0.32682099176443025
893,wherein,6495,2756,2793,12044,0.3739394950472833,0.18798209057611634,0.43807841437660044
894,whereof,3968,2870,3377,10215,0.23949517998181222,0.2052211375823649,0.5552836824358228
895,which,521831,489680,137739,1149250,0.35325456991093107,0.3927221169053265,0.25402331318374244
896,who,237709,147650,46742,432101,0.4402238655401171,0.32394888484529233,0.23582724961459048
897,whole,52454,40724,16183,109361,0.362280905347533,0.33322098307518133,0.30449811157728573
898,whom,46614,32620,15658,94892,0.36440824858883536,0.30211400894611246,0.3334777424650522
899,whose,35486,20342,5485,61313,0.47614028636476563,0.3233602341458121,0.20049947948942212
900,will,284656,494022,48040,826718,0.2844257856515623,0.5848035410565943,0.13077067329184336
901,with,637178,592634,112760,1342572,0.3869947589291847,0.4264282369926222,0.1865770040781931
902,within,29947,25348,35020,90315,0.19273014637164265,0.19326584377942643,0.614004009848931
903,without,83757,70708,20689,175154,0.37409956451503057,0.37415342277853103,0.25174701270643846
904,witness,6363,2028,1900,10291,0.45639652352816323,0.17233101071416668,0.3712724657576701
905,witnesses,3733,1874,2304,7911,0.30523292809374025,0.18153403443636784,0.5132330374698918
906,work,26394,15716,2605,44715,0.5065064821750029,0.35730319164904456,0.13619032617595256
907,writ,4667,1614,5987,12268,0.20389116860215833,0.0835370673002201,0.7125717640976216
908,writing,6771,15056,8690,30517,0.14023716763841892,0.3694324193915655,0.49033041297001556
909,writings,3527,1164,752,5443,0.5071387942071317,0.19828480494853618,0.2945764008443322
910,writs,771,528,2097,3396,0.1084473843593448,0.08798602673034517,0.8035665889103101
911,yards,2680,1676,256,4612,0.4997189354478467,0.37023724571623734,0.1300438188359159
912,year,31332,30024,22629,83985,0.24373261724816225,0.2767000041526675,0.47956737859917037
913,years,50594,29310,13079,92983,0.41830673088011555,0.2870957310712306,0.29459753804865385
914,yeas,603,166,3908,4677,0.05268068253105062,0.01718134858029992,0.9301379688886494
